777777711177
777777771177
777777777177
777777777777
777777777777
777777777777
777777777777
777777777777
777777777777
777777777777
777777777177
777777777177